####################
#,,,,,,,#,,,,,,,,,,#
#,,,,,,,#,#####,,,,#
#,,,,,,,#,#,,,,,,,,#
#,,,,,,,#,#,,,,,,,,#
#,,,,,,,,,#,,,,,,,,#
#,,,,,,,,,#,,,,,,,,#
#,,,,,,,,,#,,,,,,,,#
#,,,,,,,,,,,,,,,,,,#
#,,,,,,,,,,,,,,,,,,#
####################
