########################################
#,,,,,,,#,,,,,,,,,,,,,,,,,#,,,,,,,,,,,,#
#,,,,,,,#,#####,,,#,,,,,,,#,#####,,,,,,#
#,,,,,,,#,#,,,,,,,#,,,,,,,#,#,,,,,,,,,,#
#,,,,,,,#,#,,,,,,,#,,,,,,,#,#,,,,,,,,,,#
#,,,,,,,,,#,,,,,,,#,,,,,,,,,#,,,,,,,,,,#
######,####,,,,,,,#,,,,,,,,,#,,,,,,,,,,#
#,,,,,,,,,#,,,,,,,#,,,,,,,,,#,,,,,,,,,,#
#,,,,,,,,,,,,,,,,,#,,,,,,,,,,,,,,,,,,,,#
#,,,,,,,,,,,,,,,,,#,,,,,,,,,,,,,,,,,,,,#
########################################
#,,,,,,,#,##################,,,,,,,,,,,#
#,,,,,,,,,,,,,,,,,,,,,,,,,,,,,,,,,,,,,,#
#,,,,,,,,,,,,,,,,,,,,,,,,,,,,,,,,,,,,,,#
#,,,,,,,,,,,,,,,,,,,,,,,,,,,,,,,,,,,,,,#
#,,,,,,,#,#########,#######,#,,,,,,,,,,#
#,,,,,,,#,#,,,,,,,,,,,,,,,#,#,,,,,,,,,,#
########################################
#,#########,,,,#,,,,,########,,,,,,,,,,#
#,,,,,,,,,#,,,,#,,,,,,,,,,,,,,,,,,,,,,,#
#,,,,,,,,,,,,,,#,,,,,,,,,,,,,,,,,,,,,,,#
#,,,,,,,#,,,,,,,,,,,,,,,,,#,,,,,,,,,,,,#
#,,,,,,,#,,,,,,,,,,,,,,,,,#,#####,,,,,,#
#,,,,,,,#,#########,#######,#,,,,,,,,,,#
#,,,,,,,#,#,,,,,,,,,,,,,,,#,#,,,,,,,,,,#
#,,,,,,,,,#,,,,#,,,,,,,,,,,,#,,,,,,,,,,#
#,,,,,,,,,#,,,,#,,,,,########,,,,,,,,,,#
#,,,,,,,,,#,,,,#,,,,,,,,,,,,#,,,,,,,,,,#
#,,,,,,,,,,,,,,#,,,,,,,,,,,,,,,,,,,,,,,#
########################################
