###################,###################
#,,,,,,,,,#,,,#,,,,,#,,,,,,,,,,,,,,,#,#
#,#,#####,#,#,#,#,###,#,###,#######,#,#
#,#,#,,,,,#,#,#,#,,,,,#,#,#,#,,,,,#,#,#
#,#,###,###,###,#######,#,#,#,###,#,#,#
#,#,,,#,#,,,,,#,#,,,,,#,#,,,#,#,#,#,,,#
#,###,#,#####,#,###,###,#####,#,#,###,#
#,#,,,#,,,,,,,#,,,#,,,#,,,#,,,#,#,#,#,#
#,#,#########,###,###,###,#,###,#,#,#,#
#,#,,,#,,,#,#,,,#,,,#,,,#,,,,,,,#,#,#,#
#####,#,#,#,###,###,#,###########,#,#,#
#,,,#,#,#,,,,,#,#,#,#,,,,,#,,,,,,,#,#,#
#,#,#,#,#####,#,#,#,#####,#,#######,#,#
#,#,#,#,,,,,#,#,,,#,,,#,,,#,,,,,,,#,,,#
#,#,#,#,###,#####,###,#,#########,#,###
#,#,,,#,,,#,,,,,,,#,,,#,,,,,#,,,,,#,#,#
#,#######,#########,###,###,#,#######,#
#,,,#,#,,,#,#,,,,,#,,,#,,,#,#,,,,,,,,,#
###,#,#,###,#,###,###,###,#,###########
#,,,#,#,,,#,#,#,#,#,,,#,,,#,,,,,,,,,#,#
#,###,###,#,#,#,#,#,#######,#####,#,#,#
#,#,,,,,,,,,#,,,#,,,#,,,,,#,#,,,,,#,,,#
#,#########,###,#####,###,###,#######,#
#,,,,,,,#,,,,,#,#,,,,,,,#,,,#,,,,,,,#,#
#,#####,#######,#,#####,###,#,#####,#,#
#,,,#,,,#,,,#,,,#,,,#,,,#,,,#,,,,,#,#,#
###,#,###,#,#,#######,###,#########,#,#
#,,,#,,,,,#,,,,,,,,,,,#,,,,,,,,,,,,,#,#
###################,###################