########################################cd ..
#,,,,,,,#,,,,,,,,,,,,,,,,,#,,,,,,,,,,,,#
#,,,,,,,#,#####,,,#,,,,,,,#,#####,,,,,,#
#,,,,,,,#,#,,,,,,,#,,,,,,,#,#,,,,,,,,,,#
#,,,,,,,#,#,,,,,,,#,,,,,,,#,#,,,,,,,,,,#
#,,,,,,,,,#,,,,,,,#,,,,,,,,,#,,,,,,,,,,#
######,####,,,,,,,#,,,,,,,,,#,,,,,,,,,,#
#,,,,,,,,,#,,,,,,,#,,,,,,,,,#,,,,,,,,,,#
#,,,,,,,,,,,,,,,,,#,,,,,,,,,,,,,,,,,,,,#
#,,,,,,,,,,,,,,,,,#,,,,,,,,,,,,,,,,,,,,#
######,#######,######,##############,###
#,,,,,,,#,,,,,,,,,,,,,,,,,#,,,,,,,,,,,,#
#,,,,,,,#,,,,,,,,,,,,,,,,,#,#####,,,,,,#
#,,,,,,,#,#########,#######,#,,,,,,,,,,#
#,,,,,,,#,#,,,,,,,,,,,,,,,#,#,,,,,,,,,,#
#,,,,,,,,,#,,,,#,,,,,,,,,,,,#,,,,,,,,,,#
#,#########,,,,#,,,,,########,,,,,,,,,,#
#,,,,,,,,,#,,,,#,,,,,,,,,,,,,,,,,,,,,,,#
#,,,,,,,,,,,,,,#,,,,,########,,,,,,,,,,#
#,,,,,,,,,,,,,,#,,,,,,,,,,,,,,,,,,,,,,,#
#,,,,,,,#,,,,,,,,,,,,,,,,,#,,,,,,,,,,,,#
#,,,,,,,#,,,,,,,,,,,,,,,,,#,#####,,,,,,#
#,,,,,,,#,#########,#######,#,,,,,,,,,,#
#,,,,,,,#,#,,,,,,,,,,,,,,,#,#,,,,,,,,,,#
#,,,,,,,,,#,,,,#,,,,,,,,,,,,#,,,,,,,,,,#
#,,,,,,,,,#,,,,#,,,,,########,,,,,,,,,,#
#,,,,,,,,,#,,,,#,,,,,,,,,,,,#,,,,,,,,,,#
#,,,,,,,,,,,,,,#,,,,,,,,,,,,,,,,,,,,,,,#
#,,,,,,,,,,,,,,#,,,,,,,,,,,,,,,,,,,,,,,#
########################################
